25
74 11 2 500 500 2 12 500 500 0 12
72 23 2 500 500 0 12 500 500 2 12
70 11 2 500 500 2 12 500 500 0 12
68 23 2 500 500 0 12 500 500 2 12
66 11 2 500 500 2 12 500 500 0 12
64 23 2 500 500 0 12 500 500 2 12
62 11 2 500 500 2 12 500 500 0 12
60 23 2 500 500 0 12 500 500 2 12
58 11 2 500 500 2 12 500 500 0 12
56 23 2 500 500 0 12 500 500 2 12
54 11 2 500 500 2 12 500 500 0 12
52 23 2 500 500 0 12 500 500 2 12
50 11 2 500 500 2 12 500 500 0 12
48 23 2 500 500 0 12 500 500 2 12
81 23 2 1000 1000 0 2 1000 1000 2 2
83 21 2 1000 1000 2 2 1000 1000 0 2
85 23 2 1000 1000 0 2 1000 1000 2 2
87 21 2 1000 1000 2 2 1000 1000 0 2
89 23 4 1000 1000 0 1 1000 1000 3 1 1000 1000 2 1 1000 1000 1 1
80 12 2 400 400 3 10 200 200 1 10
90 13 2 200 200 1 10 400 400 3 10
80 14 2 400 400 3 10 200 200 1 10
90 15 2 200 200 1 10 400 400 3 10
80 16 2 400 400 3 10 200 200 1 10
90 17 2 200 200 1 10 400 400 3 10

